16 9
1 1 1 1 0 1 1 1 1 1 1 1 1 1 1 1 
0 0 0 1 0 0 0 1 0 0 0 0 0 0 0 1 
1 1 0 1 1 1 0 1 0 1 1 1 1 1 0 1 
1 1 0 0 0 1 0 0 0 1 0 0 0 1 0 1 
1 1 1 1 0 1 1 1 1 1 0 1 0 1 0 1 
1 1 1 1 0 0 0 1 0 0 0 1 0 0 0 1 
1 1 1 1 1 1 0 1 0 1 1 1 1 1 1 1 
1 1 1 1 1 1 0 0 0 1 1 1 1 1 1 1 
1 1 1 1 1 1 1 1 1 1 1 1 1 1 1 1 
21
-1 1
2 1
2 3
4 3
4 5
6 5
6 7
8 7
8 5
10 5
10 3
12 3
12 5
14 5
14 1
8 1
8 3
6 3
6 1
4 1
4 -1
