16 9
1 0 1 1 1 1 1 1 1 1 1 1 1 1 1 1 
1 0 0 1 1 1 1 0 0 0 1 1 1 1 1 1 
1 1 0 0 1 1 1 0 0 0 0 0 0 0 0 0 
0 1 1 0 0 1 1 0 0 1 1 1 1 1 1 1 
0 0 1 1 0 0 1 1 0 0 1 0 0 0 0 0 
0 0 0 1 1 0 0 1 1 0 1 0 0 0 0 0 
0 0 0 0 1 1 0 0 1 0 1 0 0 0 0 0 
0 0 0 0 0 1 1 0 0 0 1 0 0 0 0 0 
0 0 0 0 0 0 1 1 1 1 1 0 0 0 0 0 
22
1 -1
1 1
2 1
2 2
3 2
3 3
4 3
4 4
5 4
5 5
6 5
6 6
7 6
7 7
9 7
9 4
8 4
8 3
7 2
8 1
9 2
16 2
