16 9
1 0 1 0 1 0 1 0 1 0 1 1 0 1 1 1 
1 0 0 0 1 0 0 0 1 0 1 1 0 1 1 1 
1 1 1 1 1 1 1 1 1 0 1 1 0 0 0 1 
1 0 1 0 1 0 1 0 1 0 1 1 1 1 0 1 
0 0 0 0 0 0 0 1 1 0 1 1 1 1 0 1 
0 0 0 0 0 0 0 0 1 0 1 1 1 1 0 0 
0 0 0 0 0 0 0 1 1 0 1 1 1 1 1 1 
0 0 0 0 0 0 0 0 1 0 1 0 0 0 0 0 
0 0 0 0 0 0 0 1 1 0 1 0 1 1 1 1 
18
1 -1
1 1
3 1
3 -1
5 -1
5 1
7 1
7 -1
9 -1
9 9
11 9
11 7
16 7
16 5
14 5
14 2
12 2
12 -1
