16 9
1 1 1 1 1 1 1 1 1 1 1 1 1 1 1 1 
1 1 0 0 0 0 0 0 1 0 0 0 0 0 0 1 
0 0 0 0 1 1 0 0 0 0 0 1 1 0 0 1 
1 1 1 1 1 1 1 1 1 1 1 1 1 1 0 1 
1 1 1 1 1 1 1 1 1 1 1 1 1 1 0 1 
0 0 0 0 1 1 0 0 0 0 0 1 1 0 0 1 
1 1 0 0 0 0 0 0 1 0 0 0 0 0 0 1 
1 1 1 1 1 1 1 1 1 1 1 1 1 1 1 1 
1 1 1 1 1 1 1 1 1 1 1 1 1 1 1 1 
18
-1 2
2 2
3 1
6 1
7 2
9 2
10 1
13 1
14 2
14 5
13 6
10 6
9 5
7 5
6 6
3 6
2 5
-1 5
