17 10
1 1 1 0 0 0 0 0 1 1 1 1 1 1 1 1 1
0 0 1 0 1 1 1 0 1 0 0 0 0 0 0 0 0
1 0 1 0 1 1 0 0 1 0 1 1 1 1 1 1 1
0 0 1 0 0 1 0 1 1 0 1 1 1 1 1 1 1
0 1 1 1 0 1 0 0 1 0 1 1 1 1 1 1 1
0 0 0 1 0 1 1 0 1 0 1 1 1 1 1 1 1
1 1 0 1 0 0 1 0 1 0 1 1 1 1 1 1 1
0 0 0 1 1 0 1 0 1 0 1 1 1 1 1 1 1
0 1 1 1 0 0 1 0 0 0 1 1 1 1 1 1 1
0 0 0 0 0 1 1 1 1 1 1 1 1 1 1 1 1
26
-1 1
1 1
1 3 
0 3
0 5
2 5
2 7
0 7 
0 9
4 9
4 8
5 8
5 6
4 6
4 3 
3 3
3 0
7 0
7 2
6 2
6 4
7 4
7 8
9 8
9 1
17 1

