16 9
1 1 1 0 1 1 1 1 1 1 1 1 1 1 1 1 
1 1 1 0 1 1 1 0 0 0 0 0 0 0 1 1 
1 1 1 0 1 1 1 0 1 1 1 1 1 0 1 1 
0 0 1 0 1 1 1 0 1 1 1 1 1 0 1 1 
1 0 1 0 0 0 0 0 0 0 0 0 1 0 1 1 
1 0 1 1 1 1 1 0 1 1 1 0 1 0 1 1 
1 0 0 0 0 0 0 0 1 1 1 0 0 0 1 1 
1 1 1 1 1 1 1 1 1 1 1 1 1 1 1 1 
1 1 1 1 1 1 1 1 1 1 1 1 1 1 1 1 
11
3 -1
3 4
11 4
11 6
13 6
13 1
7 1
7 6
1 6
1 3
-1 3
